{
  "ا": 1,
  "ل": 2,
  "ي": 3,
  "م": 4,
  "ر": 5,
  "و": 6,
  "ن": 7,
  "ة": 8,
  "ب": 9,
  "ت": 10,
  "د": 11,
  "ع": 12,
  "س": 13,
  "ك": 14,
  "ق": 15,
  "ف": 16,
  "ح": 17,
  "ج": 18,
  "ه": 19,
  "ط": 20,
  "ش": 21,
  "ز": 22,
  "ص": 23,
  "أ": 24,
  "خ": 25,
  "ى": 26,
  "َ": 27,
  "إ": 28,
  "غ": 29,
  "ئ": 30,
  "ّ": 31,
  "ض": 32,
  "٠": 33,
  "ء": 34,
  "ث": 35,
  "ذ": 36,
  "٢": 37,
  "ظ": 38,
  "١": 39,
  "٣": 40,
  "٥": 41,
  "ْ": 42,
  "٨": 43,
  "ُ": 44,
  "٤": 45,
  "٦": 46,
  "ؤ": 47,
  "٧": 48,
  "٩": 49,
  ".": 50,
  "ِ": 51,
  "آ": 52,
  "ً": 53,
  "/": 54,
  "-": 55,
  "ڤ": 56,
  ":": 57,
  "!": 58,
  "\"": 59,
  "+": 60,
  "ٌ": 61,
  "ڨ": 62,
  "،": 63,
  ")": 64,
  "(": 65,
  "ـ": 66,
  "#": 67,
  "٫": 68,
  "ڭ": 69,
  "٬": 70,
  "ڥ": 71,
  "پ": 72
}