{
  "া": 1,
  "র": 2,
  "্": 3,
  "ন": 4,
  "ি": 5,
  "ে": 6,
  "ক": 7,
  "স": 8,
  "ব": 9,
  "ম": 10,
  "ল": 11,
  "ত": 12,
  "প": 13,
  "ু": 14,
  "ো": 15,
  "ট": 16,
  "য়": 17,
  "দ": 18,
  "জ": 19,
  "য": 20,
  "ী": 21,
  "শ": 22,
  "ড": 23,
  "গ": 24,
  "এ": 25,
  "হ": 26,
  "ই": 27,
  "চ": 28,
  "ষ": 29,
  ",": 30,
  "ভ": 31,
  "ও": 32,
  "আ": 33,
  "ধ": 34,
  ".": 35,
  "খ": 36,
  "ফ": 37,
  "ং": 38,
  "ণ": 39,
  "অ": 40,
  "উ": 41,
  "০": 42,
  "থ": 43,
  "-": 44,
  "ড়": 45,
  "১": 46,
  "।": 47,
  "৪": 48,
  "ছ": 49,
  "ঙ": 50,
  "ূ": 51,
  "ঘ": 52,
  "ঃ": 53,
  "ঁ": 54,
  "৯": 55,
  "২": 56,
  "়": 57,
  "৭": 58,
  "ঠ": 59,
  "৫": 60,
  "ঞ": 61,
  "৩": 62,
  "ৌ": 63,
  "৮": 64,
  "ৃ": 65,
  "(": 66,
  "৬": 67,
  ")": 68,
  "/": 69,
  "ৎ": 70,
  "ৈ": 71,
  "‌": 72,
  "9": 73,
  "3": 74,
  "4": 75,
  ":": 76,
  "'": 77,
  "ঝ": 78,
  "\"": 79,
  "ঔ": 80,
  "?": 81,
  "ঈ": 82,
  "5": 83,
  "1": 84,
  "ৄ": 85,
  "ঢ": 86,
  "2": 87,
  "8": 88,
  "7": 89,
  "ঐ": 90,
  "!": 91,
  "ঋ": 92,
  "ৰ": 93,
  "%": 94,
  "`": 95,
  "~": 96,
  "৷": 97,
  "*": 98,
  "0": 99,
  "ঢ়": 100,
  ";": 101,
  "ঊ": 102,
  "[": 103,
  "]": 104,
  "৺": 105,
  "+": 106,
  "’": 107,
  "‘": 108,
  "6": 109
}