{
  "ा": 1,
  "र": 2,
  "्": 3,
  "क": 4,
  "े": 5,
  "स": 6,
  "न": 7,
  "प": 8,
  "म": 9,
  "ि": 10,
  "व": 11,
  "ी": 12,
  "ल": 13,
  "ं": 14,
  "ग": 15,
  "त": 16,
  "य": 17,
  "ह": 18,
  "ु": 19,
  "द": 20,
  "ट": 21,
  "ो": 22,
  "श": 23,
  "ड": 24,
  ".": 25,
  "ज": 26,
  "ब": 27,
  "ण": 28,
  "च": 29,
  "अ": 30,
  "भ": 31,
  "थ": 32,
  "ै": 33,
  "आ": 34,
  "ध": 35,
  "ष": 36,
  "फ": 37,
  "ू": 38,
  "ई": 39,
  "ए": 40,
  "ख": 41,
  "ौ": 42,
  "ळ": 43,
  "ॉ": 44,
  "ठ": 45,
  "ँ": 46,
  "ृ": 47,
  "छ": 48,
  ",": 49,
  "इ": 50,
  "‌": 51,
  "उ": 52,
  "ॅ": 53,
  "घ": 54,
  "ऊ": 55,
  "२": 56,
  "१": 57,
  "३": 58,
  "ः": 59,
  "(": 60,
  "‍": 61,
  ")": 62,
  "ञ": 63,
  "-": 64,
  "ऑ": 65,
  "झ": 66,
  "४": 67,
  "ढ": 68,
  "८": 69,
  "औ": 70,
  "'": 71,
  "़": 72,
  "ओ": 73,
  "०": 74,
  "५": 75,
  "%": 76,
  "\"": 77,
  ":": 78,
  "७": 79,
  "९": 80,
  "६": 81,
  "|": 82,
  "ऐ": 83,
  "1": 84,
  "ॐ": 85,
  "ऋ": 86,
  "_": 87,
  "0": 88,
  "ड़": 89,
  "।": 90,
  "/": 91,
  "!": 92,
  "3": 93,
  "2": 94,
  "?": 95,
  ";": 96,
  "5": 97,
  "#": 98,
  "[": 99,
  "9": 100,
  "]": 101,
  "6": 102,
  "4": 103,
  "7": 104,
  "ढ़": 105,
  "\\": 106,
  "8": 107
}